111111111111111
1P0010C00000111
100010010110111
100000010000111
101110010000011
101001000000001
101C10010C10001
10E000110000111
111111111111111